....................
..--...#....#.--....
--.G...#..X.#...G.--
.......######.......
C.G..............G.C
####..G.G.G.G.G.####
.......GGGGGG.......
...G.GC......CG.G...
...#####....#####...
....................
CG.G............G.GC
###..............###
........G-G.........
.1..#C...G....C#..G.
####################
